SO ./textures/horse3.xpm
WE ./textures/horse4.xpm
EA ./textures/horse1.xpm
NO ./textures/horse2.xpm
F 255,54,25
C 255,22,255


11111111111
11111011111
1E000000001
10100000001
10000000011
10000000001
11111111111 





